"CH:Mimetism"	"CH: Mimetism"
"AD:Combat Jump"	"AD: Combat Jump"
"CH:TO Camouflage"	"CH: TO Camouflage"
"G:Remote Presence"	"G: Remote Presence"
"V:No Wound Incapacitation"	"V: No Wound Incapacitation"
"Veteran (V: No Wound Incapacitation,Sixth Sense L2)"	"Veteran (V: No Wound Incapacitation, Sixth Sense L2)"
"Super Jump"	"Super-Jump"
"CH:Camouflage"	"CH: Camouflage"
"CH:TO Camo"	"CH: TO Camouflage"
"V:Dogged"	"V: Dogged"
"Mimetism"	"CH: Mimetism"
"Multiterriain"	"Multiterrain"
"V:Courage"	"V: Courage"
"ODD: Optical Distruption Field"	"ODD: Optical Disruptor Field"
"Zero-G"	"Zero-G Terrain"
"G:Mnemonica"	"G: Mnemonica"
"ODD:Optical Distruptor"	"ODD: Optical Disruptor"
"Shavastii"	"Shasvastii"
"AD: Parachutist/Zero-G"	"AD: Parachutist / Zero-G"
"Eyection System"	"Ejection System"
"Ch: Mimetism"	"CH: Mimetism",
"Sixth Sense L2 OR 360° Visor"	"Sixth Sense L2 or 360° Visor"
"AD: Airborne Infiltration OR Zero-G"	"AD: Airborne Infiltration or Zero-G"
"Sixt Sense L1"	"Sixth Sense L1"
"Ghost: Jumper L1"	"G: Jumper L1"
